8 8 8 8 8 8 8 8 8 8 8 8 8 8 8 8 8 8 8 8 8 8 8 8 8 8 8 8 8 0 0 0 0 0 8 8 8 8 8 8 8 8 8 8 8 8 8 8 8 8
8 8 8 8 8 8 8 8 8 8 8 8 8 8 8 8 8 8 8 8 8 8 8 8 8 8 8 8 8 0 0 0 0 0 8 8 8 8 8 8 8 8 8 8 8 8 8 8 8 8
8 8 8 0 0 0 0 0 0 0 0 0 0 0 0 0 0 0 0 0 0 0 8 8 8 8 8 8 8 0 0 0 0 0 8 8 8 8 8 8 8 8 8 8 8 8 8 8 8 8
8 8 8 1 1 1 1 1 1 1 1 0 0 0 0 0 0 0 0 0 0 0 8 8 8 8 8 8 8 0 0 0 0 0 8 8 8 8 8 8 8 8 8 8 8 8 8 8 8 8
8 8 8 1 4 4 4 4 4 4 1 0 0 0 0 0 0 0 0 0 0 0 8 8 8 8 8 8 8 0 0 0 0 0 8 8 8 8 8 8 8 8 8 8 8 8 8 8 8 8
8 8 8 1 4 4 4 4 4 4 1 0 0 2 2 2 2 0 0 0 0 0 8 8 8 8 8 8 8 0 0 0 0 0 8 8 8 8 8 8 8 8 8 8 8 8 8 8 8 8
8 8 8 1 4 4 4 4 4 4 1 0 0 2 2 6 2 0 0 0 0 0 8 8 8 8 8 8 8 0 0 0 0 0 8 8 8 8 8 8 8 8 8 8 8 8 8 8 8 8
8 8 8 1 4 4 4 4 4 4 1 0 0 2 2 2 2 0 0 0 0 0 8 8 8 8 8 8 8 0 0 0 0 0 8 8 8 8 8 8 8 8 8 8 8 8 8 8 8 8
8 8 8 1 4 4 4 4 4 4 1 0 0 2 2 2 0 0 0 0 0 0 8 8 8 8 8 8 8 0 0 0 0 0 8 8 8 8 8 8 8 8 8 8 8 8 8 8 8 8
8 8 8 1 1 1 1 2 1 1 1 0 0 2 2 2 0 0 0 0 0 0 8 8 8 8 8 8 8 0 0 0 0 0 8 8 8 8 8 8 8 8 8 8 8 8 8 8 8 8
8 8 8 0 0 0 0 2 2 2 2 2 2 2 2 2 0 0 0 0 0 0 8 8 8 8 8 8 8 0 0 0 0 0 0 0 0 0 0 0 0 0 0 0 0 0 0 8 8 8
8 8 8 0 0 0 0 2 2 2 2 2 2 2 2 2 0 0 0 0 0 0 8 8 8 8 8 8 8 0 0 0 0 0 0 0 0 0 0 0 0 0 0 0 0 0 0 8 8 8
8 8 8 8 8 8 8 8 8 8 8 8 8 2 2 2 8 8 8 8 8 8 8 8 8 8 8 8 8 8 8 8 8 8 8 8 8 8 8 8 8 8 8 8 0 0 0 8 8 8
8 8 8 8 8 8 8 8 8 8 8 8 8 8 2 8 8 8 8 8 8 8 8 8 8 8 8 8 8 8 8 8 8 8 8 8 8 8 8 8 8 8 8 8 0 0 0 8 8 8
8 8 8 2 2 2 2 2 2 2 2 2 2 2 2 8 8 8 8 8 8 8 8 8 8 8 8 8 8 8 8 8 8 8 8 8 8 8 8 8 8 8 8 8 0 0 0 8 8 8
8 8 8 2 8 8 8 8 8 8 8 8 8 8 8 8 8 8 8 8 8 8 8 8 8 8 8 8 8 8 8 8 8 8 8 8 8 8 8 8 8 8 8 8 0 0 0 8 8 8
8 8 8 2 8 8 8 8 8 8 8 8 8 8 8 8 8 8 8 8 8 8 8 8 8 8 8 8 8 8 8 8 8 8 8 8 8 8 8 8 8 8 8 8 0 0 0 8 8 8
8 8 8 2 2 2 2 2 2 2 2 2 2 2 2 2 2 2 2 2 2 2 8 8 8 8 8 8 8 8 8 8 8 8 8 8 8 8 8 8 8 8 8 8 0 0 0 8 8 8
8 8 8 8 8 8 8 8 8 8 8 8 8 8 8 8 8 8 8 8 2 2 8 8 8 8 8 8 8 8 8 8 8 8 8 8 8 8 8 8 8 8 8 8 0 0 0 8 8 8
8 8 8 8 8 8 8 8 8 8 8 8 8 8 8 8 8 8 8 8 2 2 8 8 8 8 8 8 8 8 8 8 8 8 8 8 8 8 8 8 8 8 8 8 0 0 0 8 8 8
8 8 8 1 1 1 1 1 1 1 1 1 1 0 0 0 0 2 2 2 2 2 0 0 0 8 8 8 8 2 2 2 2 2 2 2 2 2 2 2 2 2 2 2 2 2 2 2 2 2
8 8 8 1 4 4 4 4 4 4 4 4 1 0 0 0 0 2 2 2 2 2 0 0 0 8 8 8 8 2 2 2 2 2 2 2 2 2 2 2 2 2 2 2 2 2 8 8 8 8
8 8 8 1 4 4 4 4 4 4 4 4 1 0 2 2 2 2 2 0 0 0 0 0 0 8 8 8 8 2 2 2 2 2 2 2 2 2 2 2 2 2 2 2 2 2 8 8 8 8
8 8 8 1 4 4 4 4 4 4 4 4 1 0 2 2 2 2 2 0 0 0 0 0 0 8 8 8 8 2 2 2 2 8 8 2 2 2 2 2 8 8 2 2 2 2 8 8 8 8
8 8 8 1 4 4 4 4 4 4 4 4 2 2 2 2 1 1 1 1 1 1 1 1 1 1 8 8 8 2 2 2 2 8 8 2 2 2 2 2 8 8 2 2 2 2 8 8 8 8
8 8 8 1 4 4 4 4 4 4 4 4 1 0 2 2 1 4 4 4 4 4 4 4 4 1 8 8 8 2 2 2 2 2 2 2 2 2 2 2 2 2 2 2 2 2 8 8 8 8
8 8 8 1 4 4 4 4 4 4 4 4 1 0 2 2 1 4 4 4 4 4 4 4 4 1 8 8 8 2 2 2 2 2 2 2 2 2 2 2 2 2 2 2 2 2 8 8 8 8
8 8 8 1 4 4 4 4 4 4 4 4 1 0 2 2 1 4 4 4 4 4 4 4 4 1 8 8 8 2 2 2 2 2 2 2 2 2 2 2 2 2 2 2 2 2 8 8 8 8
8 8 8 1 4 4 4 4 4 4 4 4 1 0 2 2 1 4 4 4 4 4 4 4 4 1 8 8 8 2 2 2 2 2 2 2 2 2 2 2 2 2 2 2 2 2 8 8 8 8
8 8 8 1 1 1 1 1 1 1 1 1 1 0 2 2 1 4 4 4 4 4 4 4 4 1 8 8 8 2 2 2 2 8 8 2 2 2 2 2 8 8 2 2 2 2 8 8 8 8
8 8 8 0 0 0 0 0 0 0 0 0 0 0 2 2 2 4 4 4 4 4 4 4 4 1 8 8 8 2 2 2 2 8 8 2 2 2 2 2 8 8 2 2 2 2 8 8 8 8
8 8 8 0 0 0 0 0 0 0 0 0 0 0 2 2 1 4 4 4 4 4 4 4 4 1 8 8 8 2 2 2 2 2 2 2 2 2 2 2 2 2 2 2 2 2 8 8 8 8
8 8 8 0 0 0 0 0 0 0 0 0 0 0 2 2 1 4 4 4 4 4 4 4 4 1 8 8 8 2 2 2 2 2 2 2 2 2 2 2 2 2 2 2 2 2 8 8 8 8
8 8 8 0 0 0 0 0 0 0 0 0 0 0 2 2 1 4 4 4 4 4 4 4 4 1 8 8 8 2 2 2 2 2 2 2 2 2 2 2 2 2 2 2 2 2 8 8 8 8
8 8 8 0 0 0 0 0 0 0 0 0 0 0 2 2 1 1 1 1 1 1 1 1 1 1 8 8 8 2 2 2 2 2 2 2 2 2 2 2 2 2 2 2 2 2 8 8 8 8
8 8 8 0 0 0 0 0 0 0 0 0 0 0 2 2 8 8 8 8 8 8 8 8 8 8 8 8 8 2 2 2 2 8 8 2 2 2 2 2 8 8 2 2 2 2 8 8 8 8
8 8 8 0 0 0 0 0 0 0 0 0 0 0 2 2 8 8 8 8 8 8 8 8 8 8 8 8 8 2 2 2 2 8 8 2 2 2 2 2 8 8 2 2 2 2 8 8 8 8
2 2 2 2 2 2 2 2 2 2 2 2 2 2 2 2 2 2 2 2 2 2 2 2 2 2 2 2 2 2 2 2 2 2 2 2 2 2 2 2 2 2 2 2 2 2 8 8 8 8
2 2 2 2 2 2 2 2 2 2 2 2 2 2 2 2 2 2 2 2 2 2 2 2 2 2 2 2 2 2 2 2 2 2 2 2 2 2 2 2 2 2 2 2 2 2 8 8 8 8
2 2 2 2 2 2 2 2 2 2 2 2 2 2 2 2 2 2 2 2 2 2 2 2 2 2 2 2 2 2 2 2 2 2 2 2 2 2 2 2 2 2 2 2 2 2 8 8 8 8
8 8 8 2 2 2 2 2 2 2 2 2 2 2 2 2 2 2 2 2 2 2 2 2 2 2 2 2 2 2 5 5 5 5 5 5 5 5 5 5 5 5 5 5 5 5 8 8 8 8
8 8 8 2 2 2 2 2 2 2 2 2 2 2 2 2 2 2 2 2 2 2 2 2 2 2 2 2 2 2 5 5 5 5 5 5 5 5 5 5 5 5 5 5 5 5 8 8 8 8
8 8 8 2 2 2 2 2 2 2 2 2 2 2 2 2 2 2 2 2 2 2 2 2 2 2 2 2 2 2 5 5 5 5 5 5 5 5 5 5 5 5 5 5 5 5 8 8 8 8
3 3 3 4 4 3 3 3 3 3 3 3 3 3 4 4 4 3 3 3 3 3 3 3 4 4 4 3 3 3 3 3 5 5 5 5 5 5 5 5 5 5 5 5 5 5 8 8 8 8
3 3 3 4 4 3 3 3 3 3 3 3 3 3 4 4 4 3 3 3 3 3 3 3 4 4 4 3 3 3 3 3 3 3 5 5 5 5 5 5 5 5 5 5 5 5 8 8 8 8
3 3 3 4 4 3 3 3 3 3 3 3 3 3 4 4 4 3 3 3 3 3 3 3 4 4 4 3 3 3 3 3 3 3 3 5 5 5 5 5 5 5 5 5 5 5 8 8 8 8
3 3 3 4 4 3 3 3 3 3 3 3 3 3 4 4 4 3 3 3 3 3 3 3 4 4 4 3 3 3 3 3 3 3 3 3 3 3 3 3 3 3 3 3 3 3 3 3 3 3
3 3 3 4 4 3 3 3 3 3 3 3 3 3 4 4 4 3 3 3 3 3 3 3 3 3 3 3 3 3 3 3 3 3 3 3 3 3 3 3 3 3 3 3 3 3 3 3 3 3
3 3 3 3 3 3 3 3 3 3 3 3 3 3 3 3 3 3 3 3 3 3 3 3 3 3 3 3 3 3 3 3 3 3 3 3 3 3 3 3 3 3 3 3 3 3 3 3 3 3
3 3 3 3 3 3 3 3 3 3 3 3 3 3 3 3 3 3 3 3 3 3 3 3 3 3 3 3 3 3 3 3 3 3 3 3 3 3 3 3 3 3 3 3 3 3 3 3 3 3